I1110000011
00010110000
11010010110
10010110010
10110111010
10000101010
10101100010
0011100100F
10000111101
10110000011
11000101011